NO textures/test/north.xpm42
SO textures/test/south.xpm42
WE textures/test/west.xpm42
EA textures/test/east.xpm42

F 20,20,20
C 200,200,200

	11111
1        11
1          1
111111111111
10S000000001
111111111111
11         1
111111111111