NO 			textures/wolfenstein/grey_stone.xpm
EA textures/wolfenstein/wood.xpm
SO    textures/wolfenstein/purple_stone.xpm textures/wolfenstein/grey_stone.xpm
WE textures/wolfenstein/red_brick.xpm


F  18,   53, 255
C 13, 23, 23



111111111111111111
1N0000000000000001
111111111111111111
