NO 			textures/wolfenstein/grey_stone.xpm
EA textures/wolfenstein/wood.xpm
SO    textures/wolfenstein/purple_stone.xpm textures/wolfenstein/grey_stone.xpm
WE textures/wolfenstein/red_brick.xpm


F 0, 0, 255
C 0, 255, 0



111111111111111111
1E0000000000000001
111111111111111111
