NO 			textures/wolfenstein/grey_stone.xpm
SO    textures/wolfenstein/purple_stone.xpm textures/wolfenstein/grey_stone.xpm
WE textures/wolfenstein/red_brick.xpm
EA textures/wolfenstein/wood.xpm


F 18,   53,25
C 13, 23, 255


        	11111111111111111111111111
        10111111000000000110000001
        10110000011100000000000001
        10010000000000000000000001
111111111011000001110000000000001
100000000011000001110111111111111
11110111111111011100000010001
11110111111111011101010010001
11000000110101011100000010001
10000000000000001100000010001
10000000000000001101010010001
11000001110101011111011110N0111
11110111 1110101 101111010001
11111111 1111111 111111111111
