NO textures/wolfenstein/grey_stone.xpm42
SO textures/wolfenstein/purple_stone.xpm42
WE textures/wolfenstein/red_brick.xpm42
EA textures/wolfenstein/wood.xpm42

F 18,53,25
C 153,204,255

111111111111
1       1111
1      10001
111111111111
10S000000001
111111111111
11         1
111111111111
